Thomas Hobbes

INTRODUCCIÓN

PRIMERA PARTE: D E L H O M B R E

CAPÍTULO II: DE LA IMAGINACIÓN

CAPÍTULO III: DE LA CONSECUENCIA O SERIE DE IMAGINACIONES

CAPÍTULO IV: DEL LENGUAJE

CAPÍTULO V : DE LA RAZÓN Y DE LA CIENCIA

CAPÍTULO VI : DEL ORIGEN INTERNO DE LAS MOCIONES VOLUNTARIAS, COMÚNMENTE
LLAMADAS "PASIONES", Y TÉRMINOS POR MEDIO DE LOS CUALES SE EXPRESAN

CAPÍTULO VII: DE LOS FINES O RESOLUCIONES DEL DISCURSO

CAPÍTULO VIII: DE LAS "VIRTUDES" COMÚNMENTE LLAMADAS "INTELECTUALES" Y DE SUS
"DEFECTOS" OPUESTOS

CAPÍTULO IX: DE LAS DISTINTAS "MATERIAS" DEL "CONOCIMIENTO"

CAPÍTULO X: DEL "PODER", DE LA "ESTIMACIÓN", DE LA "`DIGNIDAD", DEL "HONOR" Y
DEL "TITULO A LAS COSAS"

CAPÍTULO XI: DE LA DIFERENCIA DE "MANERAS"

CAPÍTULO XII: DE LA "RELIGIÓN"

CAPÍTULO XIII: DE LA "CONDICIÓN NATURAL" DEL GÉNERO RUMANO, EN LO QUE CONCIERNE
A SU FELICIDAD Y A SU MISERIA

CAPÍTULO XIV: DE LA PRIMERA Y DE LA SEGUNDA "LEYES NATURALES" Y DE LOS
"CONTRATOS"

CAPÍTULO XV: DE OTRAS LEYES DE NATURALEZA

CAPÍTULO XVI: DE LAS "PERSONAS", "AUTORES" Y COSAS PERSONIFICADAS

SEGUNDA PARTE: DEL ESTADO

CAPÍTULO XVIII: DE LOS "DERECHOS" DE LOS SOBERANOS POR INSTITUCIÓN

CAPÍTULO XIX: DE LAS DIVERSAS ESPECIES DE GOBIERNO POR INSTITUCIÓN Y DE LA
SUCESIÓN EN EL PODER SOBERANO

CAPÍTULO XX: DEL DOMINIO "PATERNAL" Y DEL "DESPÓTICO"

CAPÍTULO XXI: DE LA "LIBERTAD" DE LOS SÚBDITOS

CAPÍTULO XXII: DE LOS "SISTEMAS" DE SUJECIÓN POLÍTICA Y PRIVADA

CAPÍTULO XXIII: DE LOS "MINISTROS PÚBLICOS" DEL PODER SOBERANO

CAPÍTULO XXIV: DE LA "NUTRICIÓN" Y "PREPARACIÓN" DE UN ESTADO

CAPÍTULO XXV: DEL "CONSEJO"

CAPÍTULO XXVI: DE LAS "LEYES CIVILES"

CAPÍTULO XXVII: DE LOS "DELITOS", "EXIMENTES" Y "ATENUANTES"

CAPÍTULO XXVIII: DE LAS "PENAS" Y DE LAS "RECOMPENSAS"

CAPÍTULO XXIX: DE LAS CAUSAS QUE DEBILITAN O TIENDEN A LA "DESINTEGRACIÓN" DE
UN ESTADO

CAPÍTULO XXX: DE LA "MISIÓN" DEL REPRESENTANTE SOBERANO

CAPÍTULO XXXI: DEL "REINO DE DIOS POR NATURALEZA"





* * *





Thomas Hobbes



Leviatán





ÍNDICE




INTRODUCCIÓN

